DE=>AZ

 ### NİTQ ETİKETLƏRİ
 
guten morgen - sabahın xeyir
guten tag - Salam
Hallo - Salam
guten abend - axşamın xeyir


### GÜNLÜK SÖZLƏR

Ich heiße x - mənim adım x
Ich bin x Jahre alt - Mənim x yaşım var
Ich wohne in x - Mən x'da yaşayıram


### SÖZLƏR(ÜMUMİ)
witching - vacib
weich - yumşaq
schlecht - pis
wachsen - bitmək,böyümək
text - mətn


### SÖZLƏR(ÜMUMİ)
sta:at - ölkə
stadt - şəhər
bett - çarpayı
be:et - lək
tag - gün 
buch - kitab
milch - süd
fuschs - tülkü
schrank - şkaf
schreiben - yazmaq
schlafen - yatmaq
speilen - oynamaq
stehen - dayanmaq
aufstehen - ayağa qalxamq
besprechen - müzakirə etmək
spiegel - güzgü
stuhl - stuhl
platz - yer
katza - pişik
wissen - bilmək
fuß - ayaq
fluß - çayxana
klasse - sinif
klatschen - çalmaq
vater - ata
vier - dörd
vase - vaza
vitrine - vitrin
quitte - heyva
bequem - rahat
quadrat - kvadrat
verwandte - qohum
mann - kişi
karte - xəritə
kind - uşaq


witching - vacib
weich - yumşaq
schlecht - pis
wachsen - bitmək,böyümək
text - mətn


### KÖMƏKÇİ NİTQ HİSSƏSİ
auch - həmçinin
noch - hələ




### DİFTONQ
ei , ai - [ae],[ay]
au - [au],[ao]
eu , äu - [oe],[oy]



